# Any line followed by a '#' character is ignored
# Section headings must be in square brackets
# Subsections within a section should follow the format:
#   [filename within code directory][tab character \t][subsection title]

#目录格式：
#[章节标题]
#文件名.后缀	算法名称


[输入输出]
sync_with_stdio.cc 	取消同步
out_float.cc 	浮点数输出格式
fastInInt.cc	整型快速输入
fastInString.cc	字符串快速输入
fastOutInt.cc	整型快速输出
fastOutString.cc	字符串快速输出
pythonInput.py	python 输入

[动态规划]
backpack.cc	背包问题
LIS(nlogn).cc	最长单调子序列（nlogn)
DPmin.cc	单调队列优化DP

[数学]
bfisprime.cc	暴力判素数
Eratosthenes.cc	埃氏筛
eulerSieve.cc	欧拉筛
factorization.cc	分解质因数
bfispalindrome.cc	暴力判回文数
gcd.cc	最大公约数
lcm.cc	最小公倍数
exGcd.cc	扩展欧几里得
crt.cc	中国剩余定理
EulerPhi.cc	欧拉函数
inv.cc	求逆元
Cnmmodp.cc	C(n,m) mod p (n很大p可以很大）
lucas.cc	Lucas定理
mul.cc	快速乘法取模
powMod.cc	快速幂取模
nC0tonCp.cc	计算从C(n, 0)到C(n, p)的值
Stern-BrocotTree.cc	二分分数树（Stern-Brocot Tree)
mobius.cc	计算莫比乌斯函数
game.txt	博弈论

[图论]
union-find.cc 	并查集
union-find(undo).cc 	可撤销并查集（按秩合并）
Kruskal.cc	Kruskal最小生成树
MST_Prim.cc	Prim最小生成树
SPFA.cc	SPFA 最短路
dijkstra.cc	dijkstra 最短路
Floyd.cc	Floyd 任意两点间最短路
Dinic.cc	Dinic 最大流
twoSAT.cc	2-SAT问题
tarjan.cc	tarjan强连通分量
BCCpoint.cc	点双联通分量
BCCedge.cc	边双联通分量

[数据结构]
BIT.cc	树状数组
differenceArray.cc	差分数组
2DBIT.cc	二维树状数组
Heap.cc	堆
RMQ.cc	RMQ
segmentTree.cc	线段树
treap.cc	Treap树
splayTree.cc	Splay树
mo.cc	莫队算法

[字符串]
KMP.cc	KMP
trie.cc	TRIE
suffixArray.cc	后缀数组
suffixAutomathine.cc	后缀自动机
manacher.cc	最长回文子串

[几何]
Planegeometry.txt	平面几何公式

[类]
point.cc	点类
Fraction.cc	分数类
Matrix.cc	矩阵
Matrix01.cc	01矩阵

[黑科技]
bitOperation.cc	位运算
ODT.cc	珂朵莉树（Old Driver Tree)